[[14,14],
[
    [
        [0],
        [0],
        [0, 0, 4, 4, 4, 4, 4, 4, 4, 4, 4],
        [0, 0, 4, 0, 0, 0, 0, 0, 0, 0, 4],
        [0, 0, 4, 0, 0, 0, 0, 0, 0, 0, 4],
        [0, 0, 4, 0, 0, 0, 0, 0, 0, 0, 4],
        [0, 0, 4, 0, 0, 0, 0, 0, 0, 0, 4],
        [0, 0, 4, 0, 0, 0, 0, 0, 0, 0, 4],
        [0, 0, 4, 0, 0, 0, 0, 0, 0, 0, 4],
        [0, 0, 4, 0, 0, 0, 0, 0, 0, 0, 4],
        [0, 0, 4, 4, 4, 4, 4, 4, 4, 4, 4]
    ],
    [
        [0],
        [0],
        [0, 0, 4, 4, 4, 4, 0, 4, 4, 4, 4],
        [0, 0, 4, 0, 0, 0, 0, 0, 0, 0, 4],
        [0, 0, 4, 0, 0, 0, 0, 0, 0, 0, 4],
        [0, 0, 4, 0, 0, 0, 0, 0, 0, 0, 4],
        [0, 0, 0, 0, 0, 0, 0, 0, 0, 0, 0],
        [0, 0, 4, 0, 0, 0, 0, 0, 0, 0, 4],
        [0, 0, 4, 0, 0, 0, 0, 0, 0, 0, 4],
        [0, 0, 4, 0, 0, 0, 0, 0, 0, 0, 4],
        [0, 0, 4, 4, 4, 4, 0, 4, 4, 4, 4]
    ],
    [
        [0],
        [0],
        [0, 0, 4, 4, 4, 4, 0, 4, 4, 4, 4],
        [0, 0, 4, 0, 0, 0, 0, 0, 0, 0, 4],
        [0, 0, 4, 0, 0, 0, 0, 0, 0, 0, 4],
        [0, 0, 4, 0, 0, 0, 0, 0, 0, 0, 4],
        [0, 0, 0, 0, 0, 0, 0, 0, 0, 0, 0],
        [0, 0, 4, 0, 0, 0, 0, 0, 0, 0, 4],
        [0, 0, 4, 0, 0, 0, 0, 0, 0, 0, 4],
        [0, 0, 4, 0, 0, 0, 0, 0, 0, 0, 4],
        [0, 0, 4, 4, 4, 4, 0, 4, 4, 4, 4]
    ],
    [
        [0, 0, 0, 0, 0, 0, 7, 0, 0, 0, 0],
        [0, 0, 0, 0, 0, 0, 7, 0, 0, 0, 0],
        [0, 0, 3, 3, 3, 3, 3, 3, 3, 3, 3],
        [0, 0, 3, 3, 3, 3, 3, 3, 3, 3, 3],
        [0, 0, 3, 3, 3, 3, 3, 3, 3, 3, 3],
        [0, 0, 3, 3, 3, 3, 3, 3, 3, 3, 3],
        [8, 8, 3, 3, 3, 3, 3, 3, 3, 3, 3, 8, 8, 8],
        [0, 0, 3, 3, 3, 3, 3, 3, 3, 3, 3],
        [0, 0, 3, 3, 3, 3, 3, 3, 3, 3, 3],
        [0, 0, 3, 3, 3, 3, 3, 3, 3, 3, 3],
        [0, 0, 3, 3, 3, 3, 3, 3, 3, 3, 3],
        [0, 0, 0, 0, 0, 0, 7, 0, 0, 0, 0],
        [0, 0, 0, 0, 0, 0, 7, 0, 0, 0, 0],
        [0, 0, 0, 0, 0, 0, 7, 0, 0, 0, 0]
    ]
]
]