[
    [15,15],
    [
        [
            [0, 0, 0, 0, 0, 0, 0, 0, 0, 0, 0, 0, 0, 0, 0],
            [0, 0, 0, 0, 0, 0, 0, 0, 0, 0, 0, 0, 0, 0, 0],
            [0, 0, 0, 0, 0, 0, 0, 0, 0, 0, 0, 0, 0, 0, 0],
            [0, 0, 0, 4, 4, 4, 4, 4, 4, 4, 4, 4, 0, 0, 0],
            [0, 0, 0, 4, 0, 0, 0, 0, 0, 0, 0, 4, 0, 0, 0],
            [0, 0, 0, 4, 0, 0, 0, 0, 0, 0, 0, 4, 0, 0, 0],
            [0, 0, 0, 4, 0, 0, 0, 0, 0, 0, 0, 4, 0, 0, 0],
            [0, 0, 0, 4, 0, 0, 0, 0, 0, 0, 0, 4, 0, 0, 0],
            [0, 0, 0, 4, 0, 0, 0, 0, 0, 0, 0, 4, 0, 0, 0],
            [0, 0, 0, 4, 0, 0, 0, 0, 0, 0, 0, 4, 0, 0, 0],
            [0, 0, 0, 4, 0, 0, 0, 0, 0, 0, 0, 4, 0, 0, 0],
            [0, 0, 0, 4, 4, 4, 4, 4, 4, 4, 4, 4, 0, 0, 0],
            [0, 0, 0, 0, 0, 0, 0, 0, 0, 0, 0, 0, 0, 0, 0],
            [0, 0, 0, 0, 0, 0, 0, 0, 0, 0, 0, 0, 0, 0, 0],
            [0, 0, 0, 0, 0, 0, 0, 0, 0, 0, 0, 0, 0, 0, 0]
        ],
        [
            [0, 0, 0, 0, 0, 0, 0, 0, 0, 0, 0, 0, 0, 0, 0],
            [0, 0, 0, 0, 0, 0, 0, 0, 0, 0, 0, 0, 0, 0, 0],
            [0, 0, 0, 0, 0, 0, 0, 0, 0, 0, 0, 0, 0, 0, 0],
            [0, 0, 0, 4, 4, 4, 4, 4, 4, 4, 4, 4, 0, 0, 0],
            [0, 0, 0, 4, 0, 0, 0, 0, 0, 0, 0, 4, 0, 0, 0],
            [0, 0, 0, 4, 0, 0, 0, 0, 0, 0, 0, 4, 0, 0, 0],
            [0, 0, 0, 4, 0, 0, 0, 0, 0, 0, 0, 4, 0, 0, 0],
            [0, 0, 0, 4, 0, 0, 0, 0, 0, 0, 0, 4, 0, 0, 0],
            [0, 0, 0, 4, 0, 0, 0, 0, 0, 0, 0, 4, 0, 0, 0],
            [0, 0, 0, 4, 0, 0, 0, 0, 0, 0, 0, 4, 0, 0, 0],
            [0, 0, 0, 4, 0, 0, 0, 0, 0, 0, 0, 4, 0, 0, 0],
            [0, 0, 0, 4, 4, 4, 4, 4, 4, 4, 4, 4, 0, 0, 0],
            [0, 0, 0, 0, 0, 0, 0, 0, 0, 0, 0, 0, 0, 0, 0],
            [0, 0, 0, 0, 0, 0, 0, 0, 0, 0, 0, 0, 0, 0, 0],
            [0, 0, 0, 0, 0, 0, 0, 0, 0, 0, 0, 0, 0, 0, 0]
        ],
        [
            [0, 0, 0, 0, 0, 0, 0, 0, 0, 0, 0, 0, 0, 0, 0],
            [0, 0, 0, 0, 0, 0, 0, 0, 0, 0, 0, 0, 0, 0, 0],
            [0, 0, 0, 0, 0, 0, 0, 0, 0, 0, 0, 0, 0, 0, 0],
            [0, 0, 0, 4, 4, 4, 4, 0, 4, 4, 4, 4, 0, 0, 0],
            [0, 0, 0, 4, 0, 0, 0, 0, 0, 0, 0, 4, 0, 0, 0],
            [0, 0, 0, 4, 0, 0, 0, 0, 0, 0, 0, 4, 0, 0, 0],
            [0, 0, 0, 4, 0, 0, 0, 0, 0, 0, 0, 4, 0, 0, 0],
            [0, 0, 0, 4, 0, 0, 0, 0, 0, 0, 0, 0, 0, 0, 0],
            [0, 0, 0, 4, 0, 0, 0, 0, 0, 0, 0, 4, 0, 0, 0],
            [0, 0, 0, 4, 0, 0, 0, 0, 0, 0, 0, 4, 0, 0, 0],
            [0, 0, 0, 4, 0, 0, 0, 0, 0, 0, 0, 4, 0, 0, 0],
            [0, 0, 0, 4, 4, 4, 4, 4, 4, 4, 4, 4, 0, 0, 0],
            [0, 0, 0, 0, 0, 0, 0, 0, 0, 0, 0, 0, 0, 0, 0],
            [0, 0, 0, 0, 0, 0, 0, 0, 0, 0, 0, 0, 0, 0, 0],
            [0, 0, 0, 0, 0, 0, 0, 0, 0, 0, 0, 0, 0, 0, 0]
        ],
        [
            [0, 0, 0, 0, 0, 0, 0, 0, 0, 0, 0, 0, 0, 0, 0],
            [0, 0, 0, 0, 0, 0, 0, 0, 0, 0, 0, 0, 0, 0, 0],
            [0, 0, 0, 0, 0, 0, 0, 0, 0, 0, 0, 0, 0, 0, 0],
            [0, 0, 0, 4, 4, 4, 4, 0, 4, 4, 4, 4, 0, 0, 0],
            [0, 0, 0, 4, 0, 0, 0, 0, 0, 0, 0, 4, 0, 0, 0],
            [0, 0, 0, 4, 0, 0, 0, 0, 0, 0, 0, 4, 0, 0, 0],
            [0, 0, 0, 4, 0, 0, 0, 0, 0, 0, 0, 4, 0, 0, 0],
            [0, 0, 0, 4, 0, 0, 0, 0, 0, 0, 0, 0, 0, 0, 0],
            [0, 0, 0, 4, 0, 0, 0, 0, 0, 0, 0, 4, 0, 0, 0],
            [0, 0, 0, 4, 0, 0, 0, 0, 0, 0, 0, 4, 0, 0, 0],
            [0, 0, 0, 4, 0, 0, 0, 0, 0, 0, 0, 4, 0, 0, 0],
            [0, 0, 0, 4, 4, 4, 4, 4, 4, 4, 4, 4, 0, 0, 0],
            [0, 0, 0, 0, 0, 0, 0, 0, 0, 0, 0, 0, 0, 0, 0],
            [0, 0, 0, 0, 0, 0, 0, 0, 0, 0, 0, 0, 0, 0, 0],
            [0, 0, 0, 0, 0, 0, 0, 0, 0, 0, 0, 0, 0, 0, 0]
        ],
        [
            [0, 0, 0, 0, 0, 0, 0, 7, 0, 0, 0, 0, 0, 0, 0],
            [0, 0, 0, 0, 0, 0, 0, 8, 0, 0, 0, 0, 0, 0, 0],
            [0, 0, 0, 0, 0, 0, 0, 7, 0, 0, 0, 0, 0, 0, 0],
            [0, 0, 0, 3, 3, 3, 3, 3, 3, 3, 3, 3, 0, 0, 0],
            [0, 0, 0, 3, 3, 3, 3, 3, 3, 3, 3, 3, 0, 0, 0],
            [0, 0, 0, 3, 3, 3, 3, 3, 3, 3, 3, 3, 0, 0, 0],
            [0, 0, 0, 3, 3, 3, 3, 3, 3, 3, 3, 3, 0, 0, 0],
            [0, 0, 0, 3, 3, 3, 3, 3, 3, 3, 3, 3, 7, 8, 7],
            [0, 0, 0, 3, 3, 3, 3, 3, 3, 3, 3, 3, 0, 0, 0],
            [0, 0, 0, 3, 3, 3, 3, 3, 3, 3, 3, 3, 0, 0, 0],
            [0, 0, 0, 3, 3, 3, 3, 3, 3, 3, 3, 3, 0, 0, 0],
            [0, 0, 0, 3, 3, 3, 3, 3, 3, 3, 3, 3, 0, 0, 0],
            [0, 0, 0, 0, 0, 0, 0, 0, 0, 0, 0, 0, 0, 0, 0],
            [0, 0, 0, 0, 0, 0, 0, 0, 0, 0, 0, 0, 0, 0, 0],
            [0, 0, 0, 0, 0, 0, 0, 0, 0, 0, 0, 0, 0, 0, 0]
        ]
    ]
]